3,4,4,4,4,4,4,4,4,4,4,4,4,4,4,4,4,4,4,4,4,4,4,4,4,4,4,4,4,4,4,4,4,4,4,4,4,4,4,4,4,4,4,4,4,4,4,4,4,4,4,4,4,4,4,4,4,4,4,4,4,6,4,5
10,11,11,11,11,11,11,11,11,11,11,11,11,11,11,11,11,11,11,11,11,11,11,11,11,11,11,11,11,11,11,11,11,11,11,11,11,11,11,11,11,11,11,11,11,11,11,11,11,11,11,11,11,11,11,11,11,11,11,11,11,6,11,12
10,11,11,11,11,11,11,11,11,11,11,11,11,11,11,11,11,11,11,11,11,11,11,11,11,11,11,11,11,11,11,11,11,11,11,11,11,11,11,11,11,11,11,11,11,11,11,11,11,11,11,11,11,11,11,11,11,11,11,11,11,6,11,12
10,11,11,11,11,11,11,11,11,11,11,11,11,11,11,11,11,11,11,11,11,11,11,11,11,11,11,11,11,11,11,11,11,11,11,11,11,11,11,11,11,11,11,11,11,11,11,11,11,11,11,11,11,11,11,11,11,11,11,11,11,6,11,12
10,11,11,11,11,11,11,11,11,11,11,11,11,11,11,11,11,11,11,11,11,11,11,11,11,11,11,11,11,11,11,11,11,11,11,11,11,11,11,11,11,11,11,11,11,11,11,11,11,11,11,11,11,11,11,11,11,11,11,11,11,6,11,12
10,11,11,11,11,11,11,11,11,11,11,11,11,11,11,11,11,11,11,11,11,11,11,11,11,11,11,11,11,11,11,11,11,11,11,11,11,11,11,11,11,11,11,11,11,11,11,11,11,11,11,11,11,11,11,11,11,11,11,11,11,6,11,12
10,11,11,11,11,11,11,11,11,11,11,11,11,11,11,11,11,11,11,11,11,11,11,11,11,11,11,11,11,11,11,11,11,11,11,11,11,11,11,11,11,11,11,11,11,11,11,11,11,11,11,0,1,1,1,1,1,1,1,1,1,1,1,19
10,11,11,11,11,11,11,11,11,11,11,11,11,11,11,11,11,11,11,11,11,11,11,11,11,11,11,11,11,11,11,11,11,11,11,11,11,11,11,11,11,11,11,11,11,11,11,11,11,11,11,14,15,15,15,15,15,15,15,15,15,15,15,5
10,11,11,11,11,11,11,11,11,11,11,11,11,11,11,11,11,11,11,11,11,11,11,11,11,11,11,11,11,11,11,11,11,11,11,11,11,11,11,11,11,11,11,11,11,11,11,11,11,11,11,11,11,11,11,11,11,11,11,11,11,11,11,12
10,11,11,11,11,11,11,11,11,11,11,11,11,11,11,11,11,11,11,11,11,11,11,11,11,11,11,11,11,11,11,11,11,11,11,11,11,11,11,11,11,11,11,11,11,0,1,1,1,2,11,11,11,11,11,11,11,11,11,11,11,11,11,12
10,11,11,11,11,11,11,11,11,11,11,11,11,11,11,11,11,11,11,11,11,11,11,11,11,11,11,11,11,11,11,11,11,11,11,11,11,11,11,11,11,11,11,11,11,14,15,15,15,16,11,11,11,11,11,11,11,11,11,11,11,11,11,12
10,11,11,11,11,11,11,11,11,11,11,11,11,11,11,11,11,11,11,11,11,11,11,11,11,11,11,11,11,11,11,11,11,11,11,11,11,11,11,11,11,11,11,11,11,11,11,11,11,11,11,11,11,11,11,11,11,11,11,11,11,11,11,12
10,11,11,11,11,11,11,11,11,11,11,11,11,11,11,11,11,11,11,11,11,11,11,11,11,11,11,11,11,11,11,11,11,11,11,11,11,11,11,11,0,1,1,2,11,11,11,11,11,11,11,11,11,11,11,11,11,11,11,11,11,11,11,12
10,11,11,11,11,11,11,11,11,11,11,11,11,11,11,11,11,11,11,11,11,11,11,11,11,11,11,11,11,11,11,11,11,11,11,11,11,11,11,11,14,15,15,16,11,11,11,11,11,11,11,11,11,11,11,11,11,11,11,11,11,11,11,12
10,11,11,11,11,11,11,11,11,11,11,11,11,11,11,11,11,11,11,11,11,11,11,11,11,11,11,11,11,11,11,11,11,11,11,11,11,11,11,11,11,11,11,11,11,11,11,11,11,11,11,11,11,11,11,11,11,11,11,11,11,11,11,12
10,11,11,11,0,1,1,1,1,1,1,1,1,1,1,1,1,1,1,1,1,1,1,1,1,2,11,11,11,11,11,11,11,0,1,1,1,1,2,11,11,11,11,11,11,11,11,11,11,11,11,11,11,11,11,11,11,11,11,11,11,11,11,12
10,11,11,11,7,8,8,8,8,8,8,8,8,8,8,8,8,8,8,8,3,15,15,15,15,16,11,11,11,11,11,11,11,14,15,15,15,15,16,11,11,11,11,11,11,11,11,11,11,11,11,11,11,11,11,11,11,11,11,11,11,11,11,12
10,11,11,11,7,8,8,8,8,8,8,8,8,8,8,8,8,8,8,8,9,11,11,11,11,11,11,11,0,1,2,11,11,11,11,11,11,11,11,11,11,11,11,11,11,11,11,11,11,11,11,11,11,11,11,11,11,11,11,11,11,11,11,12
10,11,11,11,7,8,8,8,8,8,8,8,8,8,8,8,8,8,8,8,9,11,11,11,11,11,11,11,11,11,11,11,11,11,11,11,11,11,11,11,11,11,11,11,11,11,11,11,11,11,11,11,11,11,11,11,11,11,11,11,11,11,11,12
10,11,11,11,7,8,8,8,8,8,8,8,8,8,8,8,8,8,8,8,9,11,11,11,0,1,2,11,11,11,11,11,11,11,11,11,11,11,11,11,11,11,11,11,11,11,11,11,11,11,11,11,11,11,11,11,11,11,11,11,11,11,11,12
10,11,11,11,7,8,8,8,8,8,8,8,8,8,8,8,8,8,8,8,17,2,11,11,11,11,11,11,11,11,11,11,11,11,11,11,11,11,11,11,11,11,11,11,11,11,11,11,11,11,11,11,11,11,11,11,11,11,11,11,11,11,11,12
10,11,11,11,7,8,8,8,8,8,8,8,8,8,8,8,8,8,8,8,8,9,11,11,11,11,11,11,11,11,11,11,11,11,11,11,11,11,11,11,11,11,11,11,11,11,11,11,11,11,11,11,11,11,11,11,11,11,11,11,11,11,11,12
10,11,11,11,7,8,8,8,8,8,8,8,8,8,8,8,8,8,8,8,8,17,1,1,1,1,1,1,1,1,1,2,11,11,11,11,11,11,11,11,11,11,11,11,11,11,11,11,11,11,11,11,11,11,11,11,11,11,11,11,11,11,11,12
10,11,11,11,7,3,4,4,4,4,4,4,4,4,4,4,4,4,5,8,8,8,8,8,8,8,8,8,8,8,8,9,11,11,11,11,11,11,11,11,11,11,11,11,11,11,11,11,11,11,11,11,11,11,11,11,11,11,11,11,11,11,11,12
10,11,11,11,7,9,11,11,11,11,11,11,11,11,11,11,11,11,12,8,8,8,8,8,8,8,8,8,8,8,8,9,11,11,11,11,11,0,1,1,1,1,2,11,11,11,11,11,11,11,11,11,11,11,11,11,11,11,11,11,11,11,11,12
10,11,11,11,7,9,11,11,11,11,11,11,11,11,11,11,11,11,12,8,8,8,8,8,8,8,8,8,8,8,8,17,18,18,18,18,18,19,8,8,8,8,9,11,11,11,11,11,11,11,11,11,11,11,11,11,11,11,11,11,11,11,11,12
10,11,11,11,7,9,11,11,11,11,11,11,11,11,11,11,11,11,12,8,8,8,8,8,8,8,8,8,8,8,8,8,8,8,8,8,8,8,8,8,8,8,9,11,11,11,11,11,11,11,11,11,11,11,11,11,11,11,11,11,11,11,11,12
10,11,11,11,7,9,11,11,11,11,11,11,11,11,11,11,11,11,12,8,8,8,8,8,8,8,8,8,8,8,8,8,8,8,8,8,8,8,8,8,8,8,9,11,11,11,11,11,11,11,11,11,11,11,11,11,11,11,11,11,11,11,11,12
10,11,11,11,7,9,11,11,11,11,11,11,11,11,11,11,11,11,12,8,8,8,8,8,8,8,8,8,8,8,8,8,8,8,8,8,8,8,8,8,8,8,9,11,11,11,11,11,11,11,11,11,11,11,11,11,11,11,11,11,11,11,11,12
10,11,11,11,7,9,11,11,11,11,11,11,11,11,11,11,11,11,12,8,8,8,8,8,8,8,8,8,8,8,8,8,8,8,8,8,8,8,8,8,8,8,9,11,11,11,11,11,11,11,11,11,11,11,11,11,11,11,11,11,11,11,11,12
10,11,11,11,7,9,11,11,11,11,11,11,11,11,11,11,11,11,12,8,8,8,8,8,8,8,8,8,8,8,8,8,8,8,8,8,8,8,8,8,8,8,9,11,11,11,11,11,11,11,11,11,11,11,11,11,11,11,11,11,11,11,11,12
10,11,11,11,7,9,11,11,11,11,11,11,11,11,11,11,11,11,12,8,8,8,8,8,8,8,8,8,8,8,8,8,8,8,8,8,8,8,8,8,8,8,9,11,11,11,11,11,11,11,11,11,11,11,11,11,11,11,11,11,11,11,11,12
10,11,11,11,7,9,11,11,11,11,11,11,11,11,11,11,11,11,12,8,8,8,8,8,8,8,8,8,8,8,8,8,8,8,8,8,8,8,8,8,8,8,9,11,11,11,11,11,11,11,11,11,11,11,11,11,11,11,11,11,11,11,11,12
10,11,11,11,7,9,11,11,11,11,11,11,11,11,11,11,11,11,12,8,8,8,8,8,8,8,8,8,8,8,8,8,8,8,8,8,8,8,8,8,8,8,9,11,11,11,11,11,11,11,11,11,11,11,11,11,11,11,11,11,11,11,11,12
10,11,11,11,7,9,11,11,11,11,11,11,11,11,11,11,11,11,12,8,8,8,8,8,8,8,8,8,8,8,8,8,8,8,8,8,8,8,8,8,8,8,9,11,11,11,11,11,11,11,11,11,11,11,11,11,11,11,11,11,11,11,11,12
10,11,11,11,7,9,11,11,11,11,11,11,11,11,11,11,11,11,12,8,8,8,8,8,8,8,8,8,8,8,8,8,8,8,8,8,8,8,8,8,8,8,9,11,11,11,11,11,11,11,11,11,11,11,11,11,11,11,11,11,11,11,11,12
10,11,11,11,7,9,11,11,11,11,11,11,11,11,11,11,11,11,12,8,8,8,8,8,8,8,8,8,8,8,8,8,8,8,8,8,8,8,8,8,8,8,9,11,11,11,11,11,11,11,11,11,11,11,11,11,11,11,11,11,11,11,11,12
10,11,11,11,7,9,11,11,11,11,11,11,11,11,11,11,11,11,12,8,8,8,8,8,8,8,8,8,8,8,8,8,8,8,8,8,8,8,8,8,8,8,9,11,11,11,11,11,11,11,11,11,11,11,11,11,11,11,11,11,11,11,11,12
10,11,11,11,7,9,11,11,11,11,11,11,11,11,11,11,11,11,12,8,8,8,8,8,8,8,8,8,8,8,8,8,8,8,8,8,8,8,8,8,8,8,9,11,11,11,11,11,11,11,11,11,11,11,11,11,11,11,11,11,11,11,11,12
10,11,11,11,7,9,11,11,11,11,11,11,11,11,11,11,11,11,12,8,8,8,8,8,8,8,8,8,8,8,8,8,8,8,8,8,8,8,8,8,8,8,9,11,11,11,11,11,11,11,11,11,11,11,11,11,11,11,11,11,11,11,11,12
10,11,11,11,7,9,11,11,11,11,11,11,11,11,11,11,11,11,12,8,8,8,8,8,8,8,8,8,8,8,8,8,8,8,8,8,8,8,8,8,8,8,9,11,11,11,11,11,11,11,11,11,11,11,11,11,11,11,11,11,11,11,11,12
10,11,11,11,7,9,11,11,11,11,11,11,11,11,11,11,11,11,12,8,8,8,8,8,8,8,8,8,8,8,8,8,8,8,8,8,8,8,8,8,8,8,9,11,11,11,11,11,11,11,11,11,11,11,11,11,11,11,11,11,11,11,11,12
10,11,11,11,7,9,11,11,11,11,11,11,11,11,11,11,11,11,12,8,8,8,8,8,8,8,8,8,8,8,8,8,8,8,8,8,8,8,8,8,8,8,9,11,11,11,11,11,11,11,11,11,11,11,11,11,11,11,11,11,11,11,11,12
10,11,11,11,7,9,11,11,11,11,11,11,11,11,11,11,11,11,12,8,8,8,8,8,8,8,8,8,8,8,8,8,8,8,8,8,8,8,8,8,8,8,9,11,11,11,11,11,11,11,11,11,11,11,11,11,11,11,11,11,11,11,11,12
10,11,11,11,7,9,11,11,11,11,11,11,11,11,11,11,11,11,12,8,8,8,8,8,8,8,8,8,8,8,8,8,8,8,8,8,8,8,8,8,8,8,9,11,11,11,11,11,11,11,11,11,11,11,11,11,11,11,11,11,11,11,11,12
10,11,11,11,7,9,11,11,11,11,11,11,11,11,11,11,11,11,12,8,8,8,8,8,8,8,8,8,8,8,8,8,8,8,8,8,8,8,8,8,8,8,9,11,11,11,11,11,11,11,11,11,11,11,11,11,11,11,11,11,11,11,11,12
10,11,11,11,7,9,11,11,11,11,11,11,11,11,11,11,11,11,12,8,8,8,8,8,8,8,8,8,8,8,8,8,8,8,8,8,8,8,8,8,8,8,9,11,11,11,11,11,11,11,11,11,11,11,11,11,11,11,11,11,11,11,11,12
10,11,11,11,7,9,11,11,11,11,11,11,11,11,11,11,11,11,12,8,8,8,8,8,8,8,8,8,8,8,8,8,8,8,8,8,8,8,8,8,8,8,9,11,11,11,11,11,11,11,11,11,11,11,11,11,11,11,11,11,11,11,11,12
10,11,11,11,7,17,2,11,11,11,11,11,11,11,11,11,11,11,12,8,8,8,8,8,8,8,8,8,8,8,8,8,8,8,8,8,8,8,8,8,8,8,9,11,11,11,11,11,11,11,11,11,11,11,11,11,11,11,11,11,11,11,11,12
10,11,11,11,7,8,17,2,11,11,11,11,11,11,11,11,11,11,12,8,8,8,8,8,8,8,8,8,8,8,8,8,8,8,8,8,8,8,8,8,8,8,9,11,11,11,11,11,11,11,11,11,11,11,11,11,11,11,11,11,11,11,11,12
10,11,11,11,7,8,8,17,2,11,11,11,11,11,11,11,11,11,12,8,8,8,8,8,8,8,8,8,8,8,8,8,8,8,8,8,8,8,8,8,8,8,9,11,11,11,11,11,11,11,11,11,11,11,11,11,11,11,11,11,11,11,11,12
10,11,11,11,7,8,8,8,17,2,11,11,11,11,11,11,11,11,12,8,8,8,8,8,8,8,8,8,8,8,8,8,8,8,8,8,8,8,8,8,8,8,9,11,11,11,11,11,11,11,11,11,11,11,11,11,11,11,11,11,11,11,11,12
10,11,11,11,7,8,8,8,8,17,2,11,11,11,11,11,11,11,12,8,8,8,8,8,8,8,8,8,8,8,8,8,8,8,8,8,8,8,8,8,8,8,9,11,11,11,11,11,11,11,11,11,11,11,11,11,11,11,11,11,11,11,11,12
10,11,11,11,7,8,8,8,8,8,17,2,11,11,11,11,11,11,12,8,8,8,8,8,8,8,8,8,8,8,8,8,8,8,8,8,8,8,8,8,8,8,9,11,11,11,11,11,11,11,11,11,11,11,11,11,11,11,11,11,11,11,11,12
10,11,11,11,7,8,8,8,8,8,8,17,2,11,11,11,11,11,12,8,8,8,8,8,8,8,8,8,8,8,8,8,8,8,8,8,8,8,8,8,8,8,9,11,11,11,11,11,11,11,11,11,11,11,11,11,11,11,11,11,11,11,11,12
10,11,11,11,7,8,8,8,8,8,8,8,17,2,11,11,11,11,12,8,8,8,8,8,8,8,8,8,8,8,8,8,8,8,8,8,8,8,8,8,8,8,9,11,11,11,11,11,11,11,11,11,11,11,11,11,11,11,11,11,11,11,11,12
10,11,11,11,7,8,8,8,8,8,8,8,8,17,2,11,11,11,12,8,8,8,8,8,8,8,8,8,8,8,8,8,8,8,8,8,8,8,8,8,8,8,9,11,11,11,11,11,11,11,11,11,11,11,11,11,11,11,11,11,11,11,11,12
10,11,11,11,7,8,8,8,8,8,8,8,8,8,17,2,11,11,14,4,4,4,4,4,4,4,4,4,15,15,15,15,15,15,15,15,15,15,15,15,15,15,16,11,11,11,11,11,11,11,11,11,11,11,11,11,11,11,11,11,11,11,11,12
10,11,11,11,7,8,8,8,8,8,8,8,8,8,8,17,2,11,11,11,11,11,11,11,11,11,11,11,11,11,11,11,11,11,11,11,11,11,11,11,11,11,11,11,11,11,11,11,11,11,11,11,11,11,11,11,11,11,11,11,11,11,11,12
10,11,11,11,7,8,8,8,8,8,8,8,8,8,8,8,17,1,1,1,1,1,1,1,1,1,1,2,11,11,11,11,11,11,11,11,11,11,11,11,11,11,11,11,11,11,11,11,11,11,11,11,11,11,11,11,11,11,11,11,11,11,11,12
10,11,11,11,14,15,15,15,15,15,15,15,15,15,15,15,15,15,15,15,15,15,15,15,15,15,15,16,11,11,11,11,11,11,11,11,11,11,11,11,11,11,11,11,11,11,11,11,11,11,11,11,11,11,11,11,11,11,11,11,11,11,11,12
10,11,11,11,11,11,11,11,11,11,11,11,11,11,11,11,11,11,11,11,11,11,11,11,11,11,11,11,11,11,11,11,11,11,11,11,11,11,11,11,11,11,11,11,11,11,11,11,11,11,11,11,11,11,11,11,11,11,11,11,11,11,11,12
10,11,11,11,11,11,11,11,11,11,11,11,11,11,11,11,11,11,11,11,11,11,11,11,11,11,11,11,11,11,11,11,11,11,11,11,11,11,11,11,11,11,11,11,11,11,11,11,11,11,11,11,11,11,11,11,11,11,11,11,11,11,11,12
17,18,18,18,18,18,18,18,18,18,18,18,18,18,18,18,18,18,18,18,18,18,18,18,18,18,18,18,18,18,18,18,18,18,18,18,18,18,18,18,18,18,18,18,18,18,18,18,18,18,18,18,18,18,18,18,18,18,18,18,18,18,18,19
