1,1,1,1,1,1,1,1,1,1,1,1,1,1,1,1,1,1,1,1,1,1,1,1,1,1,1,1,1,1
1,-1,-1,-1,-1,-1,-1,-1,-1,-1,-1,-1,-1,-1,-1,-1,-1,-1,-1,-1,-1,-1,-1,-1,-1,-1,-1,-1,-1,1
1,-1,-1,-1,-1,-1,-1,-1,-1,-1,-1,-1,-1,-1,-1,-1,-1,-1,-1,-1,-1,-1,-1,-1,-1,-1,-1,-1,-1,1
1,-1,-1,-1,-1,-1,-1,-1,-1,-1,-1,-1,-1,-1,-1,-1,-1,-1,-1,-1,-1,-1,-1,-1,-1,-1,-1,-1,-1,1
1,0,0,0,0,0,0,0,0,-1,-1,-1,-1,-1,-1,-1,-1,-1,-1,-1,-1,-1,-1,-1,-1,0,0,0,-1,1
1,16,16,16,16,16,16,16,16,0,-1,-1,-1,-1,-1,-1,-1,-1,-1,-1,-1,-1,-1,-1,-1,-1,-1,-1,-1,1
1,16,16,16,16,16,16,16,16,16,0,0,0,0,0,0,0,0,0,0,0,0,0,0,-1,-1,-1,-1,-1,1
1,16,16,16,16,16,16,16,16,16,16,16,16,16,16,16,16,16,16,16,16,16,16,-1,-1,-1,-1,-1,-1,1
1,16,16,16,16,16,16,16,16,16,16,16,16,16,16,16,16,16,16,16,-1,-1,-1,-1,-1,0,0,0,0,1
1,16,16,16,16,16,16,16,16,16,-1,-1,16,16,-1,-1,-1,-1,-1,-1,-1,-1,-1,-1,0,16,16,16,16,1
1,16,16,16,16,16,16,-1,-1,-1,-1,-1,-1,-1,-1,16,-1,-1,16,16,0,0,0,0,16,16,16,16,16,1
1,16,16,16,16,16,-1,-1,-1,-1,-1,16,16,16,16,16,16,16,16,16,16,16,16,16,16,16,16,16,16,1
1,16,22,16,22,16,22,22,-1,-1,22,16,16,16,16,16,16,22,22,16,16,16,16,16,16,16,16,22,16,1
1,22,16,16,22,22,16,16,22,-1,-1,22,22,16,22,22,16,16,22,16,22,16,16,16,22,22,16,16,16,1
1,22,22,22,22,22,-1,-1,-1,-1,-1,-1,-1,-1,-1,-1,22,22,22,16,16,22,22,16,16,16,22,22,22,1
1,22,22,22,-1,-1,-1,-1,-1,22,22,-1,-1,-1,-1,-1,-1,-1,-1,22,22,22,22,22,22,22,22,22,22,1
1,22,22,22,-1,-1,22,22,22,22,22,22,-1,-1,-1,22,22,-1,22,22,22,22,22,22,22,22,22,22,22,1
1,22,22,22,22,22,22,22,22,22,22,22,22,22,22,22,22,22,22,22,22,22,22,22,22,22,22,22,22,1
1,22,22,22,22,22,22,22,22,22,22,22,22,22,22,22,22,22,22,22,22,22,22,22,22,22,22,22,22,1
1,1,1,1,1,1,1,1,1,1,1,1,1,1,1,1,1,1,1,1,1,1,1,1,1,1,1,1,1,1
