{
  "rooms": [
    {
      "tiles": [
        [3,4,6,4,4,4,4,4,4,4,4,4,4,4,4,4,4,4,4,4,4,4,4,4,4,4,4,4,4,4,4,5],
        [10,11,6,11,11,11,11,11,11,11,11,11,11,11,11,11,11,11,11,11,11,11,11,11,11,11,11,11,11,11,11,12],
        [10,11,6,11,11,11,11,11,11,11,11,11,11,11,11,11,11,11,11,11,11,11,11,11,11,11,11,11,11,11,11,12],
        [10,11,6,11,11,11,11,11,11,11,11,11,11,11,11,11,11,11,11,11,11,11,11,11,11,11,11,11,11,11,11,12],
        [17,18,18,18,18,18,18,18,18,18,18,18,11,11,11,18,18,18,18,18,18,18,18,18,18,18,18,2,11,11,0,19],
        [8,8,8,8,8,8,8,8,8,8,8,8,13,13,13,8,8,8,8,8,8,8,8,8,8,8,3,16,11,11,12,8],
        [8,8,8,8,8,8,8,8,8,8,8,8,8,8,8,8,8,8,8,8,8,8,8,8,8,8,9,11,11,0,19,8],
        [8,8,8,8,8,8,8,8,8,8,8,8,8,8,8,8,8,8,8,8,8,8,8,8,8,3,16,11,11,12,8,8],
        [8,8,8,8,8,8,8,8,8,8,8,8,8,8,8,8,8,8,8,8,8,8,8,8,8,9,11,11,0,19,8,8],
        [8,8,8,8,8,8,8,8,8,8,8,8,8,8,8,8,8,8,8,8,8,8,8,8,3,16,11,11,12,8,8,8],
        [8,8,8,8,8,8,8,8,8,8,8,8,8,8,8,8,8,8,8,8,8,8,8,8,9,11,11,0,19,8,8,8],
        [3,4,4,4,4,4,4,4,4,4,4,4,4,4,4,4,4,4,4,4,4,4,4,4,16,11,11,12,8,8,8,8],
        [10,11,11,11,11,11,11,11,11,11,11,11,11,11,11,11,11,11,11,11,11,11,11,11,11,11,0,19,8,8,8,8],
        [10,11,11,11,11,11,11,11,11,11,11,11,11,11,11,11,11,11,11,11,11,11,11,11,11,11,12,8,8,8,8,8],
        [10,11,11,11,11,11,11,11,11,11,11,11,11,11,11,11,11,11,11,11,11,11,11,11,11,0,19,8,8,8,8,8],
        [10,11,11,11,11,11,11,11,11,11,11,11,11,11,11,11,11,11,11,11,11,11,11,11,11,12,8,8,8,8,8,8],
        [10,11,11,11,11,11,11,11,11,11,11,11,11,11,11,11,11,11,11,11,11,11,11,11,0,19,8,8,8,8,8,8],
        [10,11,11,11,11,11,11,11,11,11,11,11,11,11,11,11,11,11,11,11,11,11,11,11,12,8,8,8,8,8,8,8],
        [10,11,11,11,11,11,11,11,11,11,11,11,11,11,11,11,11,11,11,11,11,11,11,0,19,8,8,8,8,8,8,8],
        [10,11,11,11,11,11,11,11,11,11,11,11,11,11,11,11,11,11,11,11,11,11,11,12,8,8,8,8,8,8,8,8],
        [10,11,11,11,11,11,11,11,11,11,11,11,11,11,11,11,11,11,11,11,11,11,0,19,8,8,8,8,8,8,8,8],
        [10,11,11,11,11,11,11,11,11,11,11,11,11,11,11,11,11,11,11,11,11,11,12,8,8,8,8,8,8,8,8,8],
        [10,11,11,11,11,11,11,11,11,11,11,11,11,11,11,11,11,11,11,11,11,0,19,8,8,8,8,8,8,8,8,8],
        [10,11,11,11,11,11,11,11,11,11,11,11,11,11,11,11,11,11,11,11,11,12,8,8,8,8,8,8,8,8,8,8],
        [10,11,11,11,11,11,11,11,11,11,11,11,11,11,11,11,11,11,11,11,0,19,8,8,8,8,8,8,8,8,8,8],
        [10,11,11,11,11,11,11,11,11,11,11,11,11,11,11,11,11,11,11,11,12,8,8,8,8,8,8,8,8,8,8,8],
        [10,11,11,11,11,11,11,11,11,11,11,11,11,11,11,11,11,11,11,0,19,8,8,8,8,8,8,8,8,8,8,8],
        [10,11,11,11,11,11,11,11,11,11,11,11,11,11,11,11,11,11,11,12,8,8,8,8,8,8,8,8,8,8,8,8],
        [17,18,18,18,18,18,18,18,18,18,18,18,18,18,18,18,18,18,18,19,8,8,8,8,8,8,8,8,8,8,8,8],
        [8,8,8,8,8,8,8,8,8,8,8,8,8,8,8,8,8,8,8,8,8,8,8,8,8,8,8,8,8,8,8,8],
        [8,8,8,8,8,8,8,8,8,8,8,8,8,8,8,8,8,8,8,8,8,8,8,8,8,8,8,8,8,8,8,8],
        [8,8,8,8,8,8,8,8,8,8,8,8,8,8,8,8,8,8,8,8,8,8,8,8,8,8,8,8,8,8,8,8]

      ],
      "background": [
        [4,4,4,4,4,4,4,4,4,4,4,4,4,4,4,4,4,4,4,4,4,4,4,4,4,4,4,4,4,4,4,4],
        [4,8,8,8,8,8,8,8,8,8,8,8,8,8,8,8,8,8,8,8,8,8,8,8,8,8,8,8,8,8,8,4],
        [4,3,3,3,3,11,3,3,3,3,3,3,3,3,3,3,3,3,3,3,3,3,3,3,3,3,3,3,3,3,3,4],
        [4,14,14,14,14,18,14,14,14,14,14,14,14,14,14,14,14,14,14,14,14,14,14,14,14,14,14,14,14,14,14,4],
        [4,4,4,4,4,4,4,4,4,4,4,4,9,9,9,4,4,4,4,4,4,4,4,4,4,4,4,4,9,9,4,4],
        [4,4,4,4,4,4,4,4,4,4,4,4,16,16,16,4,4,4,4,4,4,4,4,4,4,4,4,4,0,0,4,4],
        [4,4,4,4,4,4,4,4,4,4,4,4,4,4,4,4,4,4,4,4,4,4,4,4,4,4,4,0,0,4,4,4],
        [4,4,4,4,4,4,4,4,4,4,4,4,4,4,4,4,4,4,4,4,4,4,4,4,4,4,4,0,0,4,4,4],
        [4,4,4,4,4,4,4,4,4,4,4,4,4,4,4,4,4,4,4,4,4,4,4,4,4,4,0,0,4,4,4,4],
        [4,4,4,4,4,4,4,4,4,4,4,4,4,4,4,4,4,4,4,4,4,4,4,4,4,4,0,0,4,4,4,4],
        [4,4,4,4,4,4,4,4,4,4,4,4,4,4,4,4,4,4,4,4,4,4,4,4,4,0,0,4,4,4,4,4],
        [4,4,4,4,4,4,4,4,4,4,4,4,4,4,4,4,4,4,4,4,4,4,4,4,4,0,0,4,4,4,4,4],
        [4,9,9,9,9,9,9,9,9,9,9,9,9,9,9,9,9,9,9,9,9,9,9,9,9,0,4,4,4,4,4,4],
        [4,0,0,0,0,0,0,0,0,0,0,0,0,0,0,0,0,0,0,0,0,0,0,0,0,0,4,4,4,4,4,4],
        [4,0,0,0,0,0,0,0,0,0,0,0,0,0,0,0,0,0,0,0,0,0,0,0,0,4,4,4,4,4,4,4],
        [4,0,0,0,0,0,0,0,0,0,0,0,0,0,0,0,0,0,0,0,0,0,0,0,0,4,4,4,4,4,4,4],
        [4,0,0,0,0,0,0,0,0,0,0,0,0,0,0,0,0,0,0,0,0,0,0,0,4,4,4,4,4,4,4,4],
        [4,0,0,0,0,0,0,0,0,0,0,0,0,0,0,0,0,0,0,0,0,0,0,0,4,4,4,4,4,4,4,4],
        [4,0,0,0,0,0,0,0,0,0,0,0,0,0,0,0,0,0,0,0,0,0,0,4,4,4,4,4,4,4,4,4],
        [4,0,0,0,0,0,0,0,0,0,0,0,0,0,0,0,0,0,0,0,0,0,0,4,4,4,4,4,4,4,4,4],
        [4,0,0,0,0,0,0,0,0,0,0,0,0,0,0,0,0,0,0,0,0,0,4,4,4,4,4,4,4,4,4,4],
        [4,0,0,0,0,0,0,0,0,0,0,0,0,0,0,0,0,0,0,0,0,0,4,4,4,4,4,4,4,4,4,4],
        [4,0,0,0,0,0,0,0,0,0,0,0,0,0,0,0,0,0,0,0,0,4,4,4,4,4,4,4,4,4,4,4],
        [4,0,0,0,0,0,0,0,0,0,0,0,0,0,0,0,0,0,0,0,0,4,4,4,4,4,4,4,4,4,4,4],
        [4,0,0,0,0,0,0,0,0,0,0,0,0,0,0,0,0,0,0,0,4,4,4,4,4,4,4,4,4,4,4,4],
        [4,0,0,0,0,0,0,0,0,0,0,0,0,0,0,0,0,0,0,0,4,4,4,4,4,4,4,4,4,4,4,4],
        [4,0,0,0,0,0,0,0,0,0,0,0,0,0,0,0,0,0,0,4,4,4,4,4,4,4,4,4,4,4,4,4],
        [4,16,16,16,16,16,16,16,16,16,16,16,16,16,16,16,16,16,16,4,4,4,4,4,4,4,4,4,4,4,4,4],
        [4,4,4,4,4,4,4,4,4,4,4,4,4,4,4,4,4,4,4,4,4,4,4,4,4,4,4,4,4,4,4,4],
        [4,4,4,4,4,4,4,4,4,4,4,4,4,4,4,4,4,4,4,4,4,4,4,4,4,4,4,4,4,4,4,4],
        [4,4,4,4,4,4,4,4,4,4,4,4,4,4,4,4,4,4,4,4,4,4,4,4,4,4,4,4,4,4,4,4],
        [4,4,4,4,4,4,4,4,4,4,4,4,4,4,4,4,4,4,4,4,4,4,4,4,4,4,4,4,4,4,4,4]

      ],
      "players": [
        {
          "type": "player",
          "x": 192.0,
          "y": 64.0,
          "health": 10,
          "facingLeft": false
        }
      ],
      "enemies": [
        {
          "type": "enemy",
          "x": 240.0,
          "y": 40.0,
          "health": 30,
          "facingLeft": false
        },
        {
          "type": "enemy",
          "x": 288.0,
          "y": 40.0,
          "health": 30,
          "facingLeft": false
        }
      ],
      "coins": [
        {
          "x": 576.0,
          "y": 190.0
        },
        {
          "x": 640.0,
          "y": 190.0
        },
        {
          "x": 704.0,
          "y": 190.0
        },
        {
          "x": 768.0,
          "y": 190.0
        },
        {
          "x": 832.0,
          "y": 190.0
        },
        {
          "x": 896.0,
          "y": 190.0
        }
      ],
      "doors": [
        {
          "x": 320.0,
          "y": 128.0,
          "currentRoom": 0,
          "destinationRoom": 1,
          "destinationX": 320.0,
          "destinationY": 128.0
        }
      ]
    }
  ]
}